65 64 64 -1 -1 -1 -1 -1 -1 -1 -1 -1 -1 -1 -1 -1
64 90 91 92 130 -1 -1 -1 -1 -1 -1 -1 -1 -1 -1 -1
112 109 109 111 92 -1 -1 -1 -1 -1 -1 -1 -1 -1 -1 -1
-1 -1 129 109 110 -1 -1 -1 -1 -1 -1 -1 -1 -1 -1 -1
0 1 1 2 110 -1 -1 -1 -1 -1 -1 -1 -1 -1 -1 -1
18 19 109 3 -1 -1 -1 -1 -1 -1 -1 -1 -1 -1 -1 -1
36 37 37 38 -1 -1 -1 -1 -1 -1 -1 -1 -1 -1 -1 -1
-1 -1 -1 -1 -1 -1 -1 -1 -1 -1 -1 -1 -1 -1 -1 -1
-1 -1 -1 -1 -1 -1 -1 -1 -1 -1 -1 -1 -1 -1 -1 -1
